{
  "17": 8069401781,
  "19": 8069401781,
  "24": 8069401781,
  "26": 8069401781,
  "28": 8069401781,
  "30": 8069401781,
  "36": 8069401781,
  "1176": 8069401781,
  "1236": 1463358618,
  "1239": 8069401781,
  "1274": 8069401781,
  "1280": 8069401781,
  "1313": 8069401781,
  "1319": 8069401781,
  "1323": 8069401781,
  "1331": 8069401781,
  "1336": 8069401781
}